0 808 0 0 0 0 0 0 0 2060 0 0 0 0
808 0 414 0 0 0 0 0 2257 0 0 0 0 0
0 414 0 1440 0 0 0 0 0 0 0 0 0 272
0 0 1440 0 517 0 0 1614 0 0 949 0 0 0
0 0 0 517 0 0 0 0 0 948 0 0 0 0
0 0 0 0 0 0 0 0 0 1423 0 0 0 0
0 0 0 0 0 0 0 237 811 0 0 0 0 0
0 0 0 1614 0 0 237 0 0 0 1217 0 0 0
0 2257 0 0 0 0 811 0 0 0 0 0 1771 0
2060 0 0 0 948 1423 0 0 0 0 0 0 0 1780
0 0 0 949 0 0 0 1217 0 0 0 792 0 0
0 0 0 0 0 0 0 0 0 0 792 0 0 0
0 0 0 0 0 0 0 0 1771 0 0 0 0 0
0 0 272 0 0 0 0 0 0 1780 0 0 0 0
